XXXXXXXXXXXXXXXXXXXXXXXXXXXXXXX
XXXXXXXXXXXXXXXXXXXXXXXXXXXXXXX
XXXXXXXXXXXXXXXXXXXXXXXXXXXXXXX
XXXXXXXXXXXXXXXXXXXXXXXXXXXXXXX
XXXXXXXXXXXXXXXXXXXXXXXXXXXXXXX
XXXXXf333fXXXXXXXXXXXXXXXXXXXXX
XXXXf3gdg3fXXXXXXXXXXXXXXXXXXXX
XXXf3ididi3fXXXXXXXXXXXXXXXXXXX
XXXf7iiiii7fXXXXXXXXXXXXXXXXXXX
XXXf7iiiii7fXXXXXXXXXXXXXXXXXXX
XXXf7iiiii7fXXXXXXXXXXXXXXXXXXX
XXXf7666667fXXXXXXXXXXXXXXXXXXX
XXX3f76667f3XXXXXXXXXXXXXXXXXXX
XXXX3f666f3XXXXXXXXXXXXXXXXXXXX
XXXXX33A33XXXXXXXXXXXXXXXXXXXXX
XXXXXXXXXXXXXXXXXXXXXXXXXXXXXXX
XXXXXXXXXXXXXXXXXXXXXXXXXXXXXXX
XXXXXXXXXXXXXXXXXXXXXXXXXXXXXXX
XXXXXXXXXXXXXXXXXXXXXXXXXXXXXXX
XXXXXXXXXXXXXXXXXXXXXXXXXXXXXXX
XXXXXXXXXXXXXXXXXXXXXXXXXXXXXXX
XXXXXXXXXXXXXXXXXXXXXXXXXXXXXXX
XXXXXXXXXXXXXXXXXXXXXXXXXXXXXXX
*
1 f 3 g d
coralcola
7 15 X