11111111111111111111111111
11111555111555511111111111
11115555544444455511111111
11155554444000055551111111
1115554440hhhhh95555511111
115550000g33333f9955551111
15555500g3666663f000555111
13555095366666663f0h905511
11355955222266666373fh0511
1115505552222622666633f951
11150955511126222211113cd1
11a09555511116111111111fd1
11595555d111661111111113i1
11598550d11664411111111131
115555000d164lm11111111111
115555040d1637311111111111
115555044d1666111111111111
115550044d11111111111111e1
115jA0440041111111111111n1
11444440044441111111111ad1
11344400000445511111aoo0g1
111344400000005555oo000g31
1111344440000000000000g311
1111133444400000000hhg3111
1111166333374hhhhhg3331111
11111166666633333331111111
11111111111111111111111111
*
1 2 3 4 5
coralcola
27 23 k