0200000000000000000000000030004
0000003000000000000000000000004
0000020000000000000000000020004
0000000000000300000000000000004
0000000000000000000000000032004
0002000020000200000000000000004
0000000000000000000000000000004
0000020000000000000000000000004
0030000000000000020000000000004
0000000000000000000000000000004
0000000000000000000000000000004
0000020000000000000000000000004
0000000000000000000000000000004
0000000000000000000000000000004
0000000000000000000000000000004
0000000000000000000000000000004
0200000000000020000000000000004
0000000000000000000040000000004
0000000020000000000000000000004
0000200000000000000000000010004
4444444444444444444444444444444
*
4 2 1